===========
=!!!!!!!!!=
=!====!====
=!!!=!!=!!!
===!=!==!!!
=!=!=!!=!!!
=!!!==!==!=
=!=!!!!!!!=
===========

11111111111
10000E00001
10111101111
10001001000
11101011000
10101001000
10001101101
1010E000001
11111111111