=##=---=##=
=.........=
=.........=
!.........~
!.........~
!.........~
=.........=
=.........=
=##=!!!=##=

1111+++1111
10000000001
10000000001
0000000000+
00000K0000+
0000000000+
10000000001
10000000001
1111+++1111