###########
#---------#
#_______--#
#---------#
#---------#
#--_______#
#---------#
#---------#
####---####

11111111111
1HG00000001
11111111001
10000E00001
10000000001
10011111111
100E0000001
10000000001
11110001111