####!!!####
#!!!!=!!!!#
#!=======!#
#!!=!!!=!!#
#=!=!!!=!=#
#!!=!=!=!!#
#!==!=!==!#
#!!!!!!!!!#
###########

11110001111
10000100001
10111111101
1001S0G1001
11010001011
10010101001
10110101101
100E00E0001
11111111111