###########
#~~~~~~~~~#
#~~~~~~~~~#
~~~~~~~~~~~
~~~~~~~~~~~
~~~~~~~~~~~
#~~~~~~~~~#
#~~~~~~~~~#
###########

11111111111
1H000E00001
1000E000001
00000E0000+
0000E00000+
00000E0000+
1000E000001
10000E000G1
11111111111